1111111111111111111111111111111111111
1011111101101000111100111110000000101
1011100001101110111001111111000100101

10111011111011101100111111111111111C1
1000000000000000000000000000000000001
1111100111101110P0E111001111111001111
1111111111111111111111111111111111111