1111111111111111111111111111111111111
1000000000011110011111100000000111111
1011111110010000011111001111000111111
1000C10000010111111110011110001111111
11111111110000001111C0111100111111111
1001111000011110111111100001111111111
1000000111000010111111100101111111111
1111110100111010C11111001101000000001
1000000101100011111110011100111111101
101111110110100011110011111000000C101
1011100001101110111001111111000100101
1011101111101110110011111111111111101
1000000000000000000000000000000000001
1111100111101110PE0111001111111001111
1111001111101110000111100111110011111
1000000000000000000000000000000000001
1011111111001110111100011111110111111
1001111100011110111100C001111101100C1
11001110011C0000111100000001100000011
1110011001101111111001111011000111111
1111000001101100000011111000000111111
1C0010C0111000011110111110111100000C1
1110110011111110111001111011110111111
1110000111111101111100000001110C11111
1C001100000000011111111C1111111111111
1111111111111111111111111111111111111