1111111111111111111111111111111111111111111
1111111111111111111111111111111111111111111
1111111111111111111111111111111111111111111
1111111111111111111111111111111111111111111
1111111111111111111111111111111111111111111
111111111111100CEP0000C00111111111111111111
1111111111111111111111111111111111111111111
1111111111111111111111111111111111111111111