111111111111111111111111111111111111111111111111111
11111111111111111111111111111111111111111111PCE1111
111111111111111111111111111111111111111111111111111