111111111111111111111111111
1E000000000000000000000C001
111111110111111111111111111
1000000000000000000000000P1
111111111111111111111111111