1111111111111111111111111111111111111
1011111101101000111100111110000000101
1011100001101110111001111111000100101
1011101111101110110011111111111111101
1000000000000000000000000000000000C01
1111100111101110P00111001111111001111
1111111111111111111111111111111111111