1111111111111111111111111111111111111
1011111101101000111100111110000000101
1011100001101110111001111111000100101
1011101111101110110011111111111111101
10000000000000000000000000000000000C1
11111001111011100E0111001111111001111
1111111111111111111111111111111111111