1111111111111111111111111111111111111
1X11110100111010C11111001101000000001
1000000101100011111110011100111111101
101111110110100011110011111000000C101
1011100001101110111001111111000100101
1011101111101110110011111111111111101
1000000000000000000000000000000000001
1111100111101110PE0111001111111001111
1111111111111111111111111111111111111